N N 1 N N N N 1 N N
N N G N N N N 1 N N
1 1 3 1 1 1 1 1 1 1
N N 5 N N N N 1 N N
N N 5 N 3 3 3 1 1 1
N N 5 N 3 N N 1 N N
N N 5 N 1 N N 1 N N
1 1 3 1 1 3 3 1 1 1
N N 1 N S N N 1 N N
N N 1 N 2 N N 1 N N
