1 1 1 1 1 1 1 1 1 1
1 1 1 1 1 1 1 1 G 1
1 1 1 1 1 1 1 1 1 1
1 1 N N N N N N 1 1
1 1 1 1 1 1 1 N 1 1
1 1 1 1 1 1 1 N 1 1
1 1 1 1 1 1 1 N 1 1
1 1 1 S 1 1 1 N 1 1
1 1 1 1 1 1 1 1 1 1
1 1 1 1 1 1 1 1 1 1
