N N N N N N N N N N
S 1 N 1 1 1 1 N 1 N
N 1 N 1 N N 1 N 1 N
N 1 1 1 1 N 1 1 1 N
N N 4 N 1 N N N N N
N N 1 1 1 N 1 N 1 N
N N 1 N N N 1 1 1 N
N 1 1 1 1 N 1 N 1 N
N 1 N N 1 1 1 4 1 G
N N N N N N N N N N
